[
  {
    "om_terrain": "lab_security_z-5",
    "type": "mapgen",
    "object": {
      "fill_ter": "t_metal_floor",
      "rows": [
        "||||||||||||||||||||||||",
        "|,,,,,,,,,,,,|````î`````",
        "|,,,,,,,,,,,,|``````````",
        "|,,,ê,,,,ê,,,|##||||||||",
        "|,,,,,,,,,,,,|><|``||``|",
        "|,,,,,,,,,,,,|||||||||||",
        "|,,,,,,,,,,,,|||||||||||",
        "|,,,,,,,,,,,,|||||||||||",
        "|,,,,,,,,,,,,|||||||||||",
        "|,,,,,,,,,,,,||≠LLLL≠|||",
        "|,,,ê,,,,ê,,,||`î````|||",
        "|,,,,,,,,,,,,#``j``j```=",
        "|,,,,,,,,,,,,#``j``j```¥",
        "|,,,ê,,,,ê,,,||````î`||ƶ",
        "|,,,,,,,,,,,,||≠LLLL≠|||",
        "|,,,,,,,,,,,,|||||||||||",
        "|,,,,,,,,,,,,|||||||||||",
        "|,,,,,,,,,,,,|||||||||||",
        "|,,,,,,,,,,,,|||||||||||",
        "|,,,,,,,,,,,,|><|``||``|",
        "|,,,ê,,,,ê,,,|##||||||||",
        "|,,,,,,,,,,,,|``````````",
        "|,,,,,,,,,,,,|````î`````",
        "||||||||||||||||||||||||"
      ],
      "palettes": [ "lab_common_palette", "lab_security_palette" ],
      "terrain": { "ƶ": "t_card_reader_broken", "¥": "t_door_metal_o" },
      "set": [ { "point": "bash", "x": [ 10, 22 ], "y": [ 10, 16 ], "repeat": [ 5, 30 ] } ],
      "place_monsters": [ { "monster": "GROUP_LAB_MILITARY", "x": [ 1, 22 ], "y": [ 1, 22 ], "density": 0.1 } ],
      "place_items": [ { "item": "ammo_casings_milspec", "x": [ 13, 22 ], "y": [ 11, 14 ], "chance": 100, "repeat": [ 10, 20 ] } ],
      "items": {
        "L": [
          { "item": "guns_milspec", "chance": 50 },
          { "item": "fcl_SUS_heavy_rail_rifle", "chance": 5 }
        ],
        "≠": [
          { "item": "ammo_milspec", "chance": 70, "repeat": [ 1, 2 ] },
          { "item": "mags_milspec", "chance": 70, "repeat": [ 1, 2 ] }
        ]
      },
      "place_monster": [
        { "monster": "mon_flashbang_hack", "x": 17, "y": 4, "chance": 100 },
        { "monster": "mon_gasbomb_hack", "x": 18, "y": 4, "chance": 100 },
        { "monster": "mon_skitterbot", "x": 21, "y": 4, "chance": 100 },
        { "monster": "mon_tazer_hack", "x": 22, "y": 4, "chance": 100 },
        { "monster": "mon_gasbomb_hack", "x": 17, "y": 19, "chance": 100 },
        { "monster": "mon_grenade_hack", "x": 18, "y": 19, "chance": 100 },
        { "monster": "mon_tazer_hack", "x": 21, "y": 19, "chance": 100 },
        { "monster": "mon_skitterbot", "x": 22, "y": 19, "chance": 100 },
        { "monster": "mon_devourer_lab_sec", "x": [ 1, 10 ], "y": 11, "chance": 100 }
      ],
      "place_nested": [
        { "chunks": [ [ "12x12_obstacle_course_N", 100 ] ], "x": 1, "y": 1 },
        { "chunks": [ [ "12x12_obstacle_course_S", 100 ] ], "x": 1, "y": 11 }
      ]
    }
  }
]